10,6
0,0,0,0,0,0,0,0,1,1,
0,0,0,0,0,0,0,0,1,1,
0,0,0,0,0,1,0,0,1,1,
0,0,0,0,0,1,0,0,1,1,
0,0,0,0,0,1,0,0,1,1,
0,1,1,1,1,1,1,1,1,1,
spawn:2,3
spawn:8,4
spawn:7,2
spawn:2,1
spawn:0,0
spawn:0,0
